"","Year","Category","SubCategory","SubSubCategory","Total","Food secure-1000","Food secure-Percent","Food insecure-1000","Food insecure-Percent","Low food security-1000","Low food security-Percent","Very low food security-1000","Very low food security-Percent"
"1",2001,"All households",NA,NA,107824,96303,89.3,11521,10.7,"8010","7.4","3511","3.3"
"2",2001,"Household composition","With children < 18 yrs",NA,38330,32141,83.9,6189,16.1,"4744","12.4","1445","3.8"
"3",2001,"Household composition","With children < 18 yrs","With children < 6 yrs",16858,13920,82.6,2938,17.4,"2304","13.7","634","3.8"
"4",2001,"Household composition","With children < 18 yrs","Married-couple families",26182,23389,89.3,2793,10.7,"2247","8.6","546","2.1"
"5",2001,"Household composition","With children < 18 yrs","Female head, no spouse",9080,6185,68.1,2895,31.9,"2101","23.1","794","8.6999999999999993"
"6",2001,"Household composition","With children < 18 yrs","Male head, no spouse",2389,2009,84.1,380,15.9,"298","12.5","82","3.4"
"7",2001,"Household composition","With children < 18 yrs","Other household with child",678,555,81.9,123,18.1,"99","14.6","24","3.5"
"8",2001,"Household composition","With no children < 18 yrs",NA,69495,64163,92.3,5332,7.7,"3266","4.7","2066","3"
"9",2001,"Household composition","With no children < 18 yrs","More than one adult",40791,38328,94,2463,6,"1595","3.9","868","2.1"
"10",2001,"Household composition","With no children < 18 yrs","Women living alone",16513,14915,90.3,1598,9.7,"952","5.8","646","3.9"
"11",2001,"Household composition","With no children < 18 yrs","Men living alone",12192,10922,89.6,1270,10.4,"718","5.9","552","4.5"
"12",2001,"Household composition","With elderly",NA,24836,23458,94.5,1378,5.5,"1002","4","376","1.5"
"13",2001,"Household composition","With elderly","Elderly living alone",10390,9758,93.9,632,6.1,"426","4.0999999999999996","206","2"
"14",2001,"Race/ethnicity of households","White non-Hispanic",NA,80337,74230,92.4,6107,7.6,"4072","5.0999999999999996","2035","2.5"
"15",2001,"Race/ethnicity of households","Black non-Hispanic",NA,13134,10331,78.7,2803,21.3,"1986","15.1","817","6.2"
"16",2001,"Race/ethnicity of households","Hispanic",NA,9864,7717,78.2,2147,21.8,"1613","16.399999999999999","534","5.4"
"17",2001,"Race/ethnicity of households","Other",NA,4489,4026,89.7,463,10.3,"339","7.6","124","2.8"
"18",2001,"Household income-to-poverty ratio","Under 1.00",NA,11693,7426,63.5,4267,36.5,"2763","23.6","1504","12.9"
"19",2001,"Household income-to-poverty ratio","Under 1.30",NA,16904,11450,67.7,5454,32.3,"3609","21.3","1845","10.9"
"20",2001,"Household income-to-poverty ratio","Under 1.85",NA,25395,18316,72.1,7079,27.9,"4811","18.899999999999999","2268","8.9"
"21",2001,"Household income-to-poverty ratio","1.85 and over",NA,63851,60743,95.1,3108,4.9,"2284","3.6","824","1.3"
"22",2001,"Household income-to-poverty ratio","Income unknown",NA,18579,17245,92.8,1334,7.2,"915","4.9000000000000004","419","2.2999999999999998"
"23",2001,"Area of residence","Inside metropolitan area",NA,86945,77826,89.5,9119,10.5,"6281","7.2","2838","3.3"
"24",2001,"Area of residence","Inside metropolitan area","In principal cities",26701,22987,86.1,3714,13.9,"2442","9.1","1272","4.8"
"25",2001,"Area of residence","Inside metropolitan area","Not in principal cities",45380,41622,91.7,3758,8.3,"2633","5.8","1125","2.5"
"26",2001,"Area of residence","Outside metropolitan area",NA,20879,18476,88.5,2403,11.5,"1730","8.3000000000000007","673","3.2"
"27",2001,"Census geographic region",NA,"Northeast",20320,18656,91.8,1664,8.2,"1176","5.8","488","2.4"
"28",2001,"Census geographic region",NA,"Midwest",25063,22805,91,2258,9,"1502","6","756","3"
"29",2001,"Census geographic region",NA,"South",38867,34073,87.7,4794,12.3,"3395","8.6999999999999993","1399","3.6"
"30",2001,"Census geographic region",NA,"West",23575,20771,88.1,2804,11.9,"1937","8.1999999999999993","867","3.7"
"31",2002,"All households",NA,NA,108601,96543,88.9,12058,11.1,"8259","7.6","3799","3.5"
"32",2002,"Household composition","With children < 18 yrs",NA,38647,32268,83.5,6379,16.5,"4899","12.7","1480","3.8"
"33",2002,"Household composition","With children < 18 yrs","With children < 6 yrs",17073,14039,82.2,3034,17.8,"2450","14.4","584","3.4"
"34",2002,"Household composition","With children < 18 yrs","Married-couple families",26069,23357,89.6,2712,10.4,"2204","8.5","508","1.9"
"35",2002,"Household composition","With children < 18 yrs","Female head, no spouse",9496,6456,68,3040,32,"2212","23.3","828","8.6999999999999993"
"36",2002,"Household composition","With children < 18 yrs","Male head, no spouse",2375,1855,78.1,520,21.9,"381","16","139","5.9"
"37",2002,"Household composition","With children < 18 yrs","Other household with child",707,599,84.7,108,15.3,"102","14.4","6","0.8"
"38",2002,"Household composition","With no children < 18 yrs",NA,69954,64276,91.9,5678,8.1,"3360","4.8","2318","3.3"
"39",2002,"Household composition","With no children < 18 yrs","More than one adult",41538,38929,93.7,2609,6.3,"1651","4","958","2.2999999999999998"
"40",2002,"Household composition","With no children < 18 yrs","Women living alone",16174,14472,89.5,1702,10.5,"985","6.1","717","4.4000000000000004"
"41",2002,"Household composition","With no children < 18 yrs","Men living alone",12242,10875,88.8,1367,11.2,"724","5.9","643","5.3"
"42",2002,"Household composition","With elderly",NA,24791,23229,93.7,1562,6.3,"1099","4.4000000000000004","463","1.9"
"43",2002,"Household composition","With elderly","Elderly living alone",10072,9327,92.6,745,7.4,"490","4.9000000000000004","255","2.5"
"44",2002,"Race/ethnicity of households","White non-Hispanic",NA,80266,73859,92,6407,8,"4294","5.3","2113","2.6"
"45",2002,"Race/ethnicity of households","Black non-Hispanic",NA,13515,10546,78,2969,22,"1999","14.8","970","7.2"
"46",2002,"Race/ethnicity of households","Hispanic",NA,10344,8099,78.3,2245,21.7,"1654","16","591","5.7"
"47",2002,"Race/ethnicity of households","Other",NA,4475,4038,90.2,437,9.8,"313","7","124","2.8"
"48",2002,"Household income-to-poverty ratio","Under 1.00",NA,11515,7128,61.9,4387,38.1,"2736","23.8","1651","14.3"
"49",2002,"Household income-to-poverty ratio","Under 1.30",NA,17010,11272,66.3,5738,33.7,"3681","21.6","2057","12.1"
"50",2002,"Household income-to-poverty ratio","Under 1.85",NA,25134,17802,70.8,7332,29.2,"4894","19.5","2438","9.6999999999999993"
"51",2002,"Household income-to-poverty ratio","1.85 and over",NA,64263,60997,94.9,3266,5.1,"2321","3.6","945","1.5"
"52",2002,"Household income-to-poverty ratio","Income unknown",NA,19204,17744,92.4,1460,7.6,"1044","5.4","416","2.2000000000000002"
"53",2002,"Area of residence","Inside metropolitan area",NA,87617,77997,89,9620,11,"6528","7.5","3092","3.5"
"54",2002,"Area of residence","Inside metropolitan area","In principal cities",26922,23047,85.6,3875,14.4,"2517","9.3000000000000007","1358","5"
"55",2002,"Area of residence","Inside metropolitan area","Not in principal cities",45552,41542,91.2,4010,8.8,"2791","6.1","1219","2.7"
"56",2002,"Area of residence","Outside metropolitan area",NA,20983,18545,88.4,2438,11.6,"1731","8.1999999999999993","707","3.4"
"57",2002,"Census geographic region",NA,"Northeast",20242,18372,90.8,1870,9.2,"1266","6.3","604","3"
"58",2002,"Census geographic region",NA,"Midwest",25180,22755,90.4,2425,9.6,"1602","6.4","823","3.3"
"59",2002,"Census geographic region",NA,"South",39195,34325,87.6,4870,12.4,"3442","8.8000000000000007","1428","3.6"
"60",2002,"Census geographic region",NA,"West",23984,21090,87.9,2894,12.1,"1950","8.1","944","3.9"
"61",2003,"All households",NA,NA,112214,99631,88.8,12583,11.2,"8663","7.7","3920","3.5"
"62",2003,"Household composition","With children < 18 yrs",NA,40286,33575,83.3,6711,16.7,"5165","12.8","1546","3.8"
"63",2003,"Household composition","With children < 18 yrs","With children < 6 yrs",18110,14933,82.5,3177,17.5,"2516","13.9","661","3.6"
"64",2003,"Household composition","With children < 18 yrs","Married-couple families",27484,24503,89.2,2981,10.8,"2446","8.9","535","1.9"
"65",2003,"Household composition","With children < 18 yrs","Female head, no spouse",9623,6572,68.3,3051,31.7,"2210","23","841","8.6999999999999993"
"66",2003,"Household composition","With children < 18 yrs","Male head, no spouse",2475,1937,78.3,538,21.7,"401","16.2","137","5.5"
"67",2003,"Household composition","With children < 18 yrs","Other household with child",704,563,80,141,20,"108","15.3","33","4.7"
"68",2003,"Household composition","With no children < 18 yrs",NA,71928,66057,91.8,5871,8.2,"3498","4.9000000000000004","2373","3.3"
"69",2003,"Household composition","With no children < 18 yrs","More than one adult",42553,39753,93.4,2800,6.6,"1840","4.3","960","2.2999999999999998"
"70",2003,"Household composition","With no children < 18 yrs","Women living alone",16724,15032,89.9,1692,10.1,"964","5.8","728","4.4000000000000004"
"71",2003,"Household composition","With no children < 18 yrs","Men living alone",12651,11271,89.1,1380,10.9,"694","5.5","686","5.4"
"72",2003,"Household composition","With elderly",NA,25946,24391,94,1555,6,"1105","4.3","450","1.7"
"73",2003,"Household composition","With elderly","Elderly living alone",10574,9921,93.8,653,6.2,"430","4.0999999999999996","223","2.1"
"74",2003,"Race/ethnicity of households","White non-Hispanic",NA,81080,74733,92.2,6347,7.8,"4169","5.0999999999999996","2178","2.7"
"75",2003,"Race/ethnicity of households","Black non-Hispanic",NA,13156,10251,77.9,2905,22.1,"2010","15.3","895","6.8"
"76",2003,"Race/ethnicity of households","Hispanic",NA,12034,9347,77.7,2687,22.3,"2034","16.899999999999999","653","5.4"
"77",2003,"Race/ethnicity of households","Other",NA,5944,5301,89.2,643,10.8,"450","7.6","193","3.2"
"78",2003,"Household income-to-poverty ratio","Under 1.00",NA,12739,8266,64.9,4473,35.1,"2863","22.5","1610","12.6"
"79",2003,"Household income-to-poverty ratio","Under 1.30",NA,18143,12245,67.5,5898,32.5,"3845","21.2","2053","11.3"
"80",2003,"Household income-to-poverty ratio","Under 1.85",NA,27104,19357,71.4,7747,28.6,"5107","18.8","2640","9.6999999999999993"
"81",2003,"Household income-to-poverty ratio","1.85 and over",NA,62145,59116,95.1,3029,4.9,"2274","3.7","755","1.2"
"82",2003,"Household income-to-poverty ratio","Income unknown",NA,22965,21160,92.1,1805,7.9,"1281","5.6","524","2.2999999999999998"
"83",2003,"Area of residence","Inside metropolitan area",NA,90708,80611,88.9,10097,11.1,"6903","7.6","3194","3.5"
"84",2003,"Area of residence","Inside metropolitan area","In principal cities",27682,23581,85.2,4101,14.8,"2804","10.1","1297","4.7"
"85",2003,"Area of residence","Inside metropolitan area","Not in principal cities",47243,42996,91,4247,9,"2879","6.1","1368","2.9"
"86",2003,"Area of residence","Outside metropolitan area",NA,21505,19020,88.4,2485,11.6,"1760","8.1999999999999993","725","3.4"
"87",2003,"Census geographic region",NA,"Northeast",21306,19267,90.4,2039,9.6,"1343","6.3","696","3.3"
"88",2003,"Census geographic region",NA,"Midwest",25941,23360,90.1,2581,9.9,"1752","6.8","829","3.2"
"89",2003,"Census geographic region",NA,"South",40554,35541,87.6,5013,12.4,"3472","8.6","1541","3.8"
"90",2003,"Census geographic region",NA,"West",24412,21463,87.9,2949,12.1,"2096","8.6","853","3.5"
"91",2004,"All households",NA,NA,112967,99473,88.1,13494,11.9,"9045","8","4449","3.9"
"92",2004,"Household composition","With children < 18 yrs",NA,39990,32967,82.4,7023,17.6,"5311","13.3","1712","4.3"
"93",2004,"Household composition","With children < 18 yrs","With children < 6 yrs",17922,14606,81.5,3316,18.5,"2573","14.4","743","4.0999999999999996"
"94",2004,"Household composition","With children < 18 yrs","Married-couple families",27065,23926,88.4,3139,11.6,"2509","9.3000000000000007","630","2.2999999999999998"
"95",2004,"Household composition","With children < 18 yrs","Female head, no spouse",9641,6459,67,3182,33,"2291","23.8","891","9.1999999999999993"
"96",2004,"Household composition","With children < 18 yrs","Male head, no spouse",2693,2096,77.8,597,22.2,"428","15.9","169","6.3"
"97",2004,"Household composition","With children < 18 yrs","Other household with child",592,487,82.3,105,17.7,"83","14","22","3.7"
"98",2004,"Household composition","With no children < 18 yrs",NA,72977,66506,91.1,6471,8.9,"3734","5.0999999999999996","2737","3.8"
"99",2004,"Household composition","With no children < 18 yrs","More than one adult",43177,40278,93.3,2899,6.7,"1834","4.2","1065","2.5"
"100",2004,"Household composition","With no children < 18 yrs","Women living alone",17012,15010,88.2,2002,11.8,"1084","6.4","918","5.4"
"101",2004,"Household composition","With no children < 18 yrs","Men living alone",12788,11219,87.7,1569,12.3,"816","6.4","753","5.9"
"102",2004,"Household composition","With elderly",NA,26202,24510,93.5,1692,6.5,"1227","4.7","465","1.8"
"103",2004,"Household composition","With elderly","Elderly living alone",10693,9911,92.7,782,7.3,"517","4.8","265","2.5"
"104",2004,"Race/ethnicity of households","White non-Hispanic",NA,81388,74383,91.4,7005,8.6,"4632","5.7","2373","2.9"
"105",2004,"Race/ethnicity of households","Black non-Hispanic",NA,13509,10303,76.3,3206,23.7,"2108","15.6","1098","8.1"
"106",2004,"Race/ethnicity of households","Hispanic",NA,12014,9404,78.3,2610,21.7,"1903","15.8","707","5.9"
"107",2004,"Race/ethnicity of households","Other",NA,6056,5382,88.9,674,11.1,"403","6.7","271","4.5"
"108",2004,"Household income-to-poverty ratio","Under 1.00",NA,13347,8438,63.2,4909,36.8,"3098","23.2","1811","13.6"
"109",2004,"Household income-to-poverty ratio","Under 1.30",NA,18367,12118,66,6249,34,"3994","21.7","2255","12.3"
"110",2004,"Household income-to-poverty ratio","Under 1.85",NA,28081,19700,70.2,8381,29.8,"5443","19.399999999999999","2938","10.5"
"111",2004,"Household income-to-poverty ratio","1.85 and over",NA,63575,60138,94.6,3437,5.4,"2443","3.8","994","1.6"
"112",2004,"Household income-to-poverty ratio","Income unknown",NA,21311,19636,92.1,1675,7.9,"1158","5.4","517","2.4"
"113",2004,"Area of residence","Inside metropolitan area",NA,92474,81661,88.3,10813,11.7,"7246","7.8","3567","3.9"
"114",2004,"Area of residence","Inside metropolitan area","In principal cities",30312,25650,84.6,4662,15.4,"3114","10.3","1548","5.0999999999999996"
"115",2004,"Area of residence","Inside metropolitan area","Not in principal cities",46444,42279,91,4165,9,"2865","6.2","1300","2.8"
"116",2004,"Area of residence","Outside metropolitan area",NA,20492,17811,86.9,2681,13.1,"1799","8.8000000000000007","882","4.3"
"117",2004,"Census geographic region",NA,"Northeast",21038,19006,90.3,2032,9.7,"1430","6.8","602","2.9"
"118",2004,"Census geographic region",NA,"Midwest",25957,23126,89.1,2831,10.9,"1889","7.3","942","3.6"
"119",2004,"Census geographic region",NA,"South",41157,35693,86.7,5464,13.3,"3605","8.8000000000000007","1859","4.5"
"120",2004,"Census geographic region",NA,"West",24815,21648,87.2,3167,12.8,"2121","8.5","1046","4.2"
"121",2005,"All households",NA,NA,114437,101851,89,12586,11,"8158","7.1","4428","3.9"
"122",2005,"Household composition","With children < 18 yrs",NA,39601,33404,84.4,6197,15.6,"4580","11.6","1617","4.0999999999999996"
"123",2005,"Household composition","With children < 18 yrs","With children < 6 yrs",17615,14671,83.3,2944,16.7,"2265","12.9","679","3.9"
"124",2005,"Household composition","With children < 18 yrs","Married-couple families",26776,24130,90.1,2646,9.9,"2040","7.6","606","2.2999999999999998"
"125",2005,"Household composition","With children < 18 yrs","Female head, no spouse",9659,6680,69.2,2979,30.8,"2143","22.2","836","8.6999999999999993"
"126",2005,"Household composition","With children < 18 yrs","Male head, no spouse",2536,2082,82.1,454,17.9,"315","12.4","139","5.5"
"127",2005,"Household composition","With children < 18 yrs","Other household with child",630,510,81,120,19,"83","13.2","37","5.9"
"128",2005,"Household composition","With no children < 18 yrs",NA,74836,68448,91.5,6388,8.5,"3577","4.8","2811","3.8"
"129",2005,"Household composition","With no children < 18 yrs","More than one adult",44267,41306,93.3,2961,6.7,"1799","4.0999999999999996","1162","2.6"
"130",2005,"Household composition","With no children < 18 yrs","Women living alone",17019,15147,89,1872,11,"1008","5.9","864","5.0999999999999996"
"131",2005,"Household composition","With no children < 18 yrs","Men living alone",13550,11996,88.5,1554,11.5,"770","5.7","784","5.8"
"132",2005,"Household composition","With elderly",NA,26609,25017,94,1592,6,"1105","4.2","487","1.8"
"133",2005,"Household composition","With elderly","Elderly living alone",10749,10063,93.6,686,6.4,"473","4.4000000000000004","213","2"
"134",2005,"Race/ethnicity of households","White non-Hispanic",NA,82144,75444,91.8,6700,8.2,"4305","5.2","2395","2.9"
"135",2005,"Race/ethnicity of households","Black non-Hispanic",NA,13732,10658,77.6,3074,22.4,"1894","13.8","1180","8.6"
"136",2005,"Race/ethnicity of households","Hispanic",NA,12397,10176,82.1,2221,17.9,"1559","12.6","662","5.3"
"137",2005,"Race/ethnicity of households","Other",NA,6164,5573,90.4,591,9.6,"400","6.5","191","3.1"
"138",2005,"Household income-to-poverty ratio","Under 1.00",NA,12646,8098,64,4548,36,"2836","22.4","1712","13.5"
"139",2005,"Household income-to-poverty ratio","Under 1.30",NA,17264,11526,66.8,5738,33.2,"3555","20.6","2183","12.6"
"140",2005,"Household income-to-poverty ratio","Under 1.85",NA,27205,19515,71.7,7690,28.3,"4813","17.7","2877","10.6"
"141",2005,"Household income-to-poverty ratio","1.85 and over",NA,65030,61621,94.8,3409,5.2,"2327","3.6","1082","1.7"
"142",2005,"Household income-to-poverty ratio","Income unknown",NA,22202,20717,93.3,1485,6.7,"1017","4.5999999999999996","468","2.1"
"143",2005,"Area of residence","Inside metropolitan area",NA,94945,84706,89.2,10239,10.8,"6593","6.9","3646","3.8"
"144",2005,"Area of residence","Inside metropolitan area","In principal cities",31708,27429,86.5,4279,13.5,"2661","8.4","1618","5.0999999999999996"
"145",2005,"Area of residence","Inside metropolitan area","Not in principal cities",46998,42932,91.3,4066,8.7,"2686","5.7","1380","2.9"
"146",2005,"Area of residence","Outside metropolitan area",NA,19492,17146,88,2346,12,"1565","8","781","4"
"147",2005,"Census geographic region",NA,"Northeast",21196,19272,90.9,1924,9.1,"1338","6.3","586","2.8"
"148",2005,"Census geographic region",NA,"Midwest",26387,23454,88.9,2933,11.1,"1859","7","1074","4.0999999999999996"
"149",2005,"Census geographic region",NA,"South",41653,36650,88,5003,12,"3173","7.6","1830","4.4000000000000004"
"150",2005,"Census geographic region",NA,"West",25202,22475,89.2,2727,10.8,"1789","7.1","938","3.7"
"151",2006,"All households",NA,NA,115609,102961,89.1,12648,10.9,"8031","6.9","4617","4"
"152",2006,"Household composition","With children < 18 yrs",NA,39436,33278,84.4,6158,15.6,"4481","11.4","1677","4.3"
"153",2006,"Household composition","With children < 18 yrs","With children < 6 yrs",17161,14295,83.3,2866,16.7,"2141","12.5","725","4.2"
"154",2006,"Household composition","With children < 18 yrs","Married-couple families",26614,23916,89.9,2698,10.1,"2140","8","558","2.1"
"155",2006,"Household composition","With children < 18 yrs","Female head, no spouse",9572,6665,69.6,2907,30.4,"1925","20.100000000000001","982","10.3"
"156",2006,"Household composition","With children < 18 yrs","Male head, no spouse",2618,2174,83,444,17,"333","12.7","111","4.2"
"157",2006,"Household composition","With children < 18 yrs","Other household with child",633,522,82.5,111,17.5,"84","13.3","27","4.3"
"158",2006,"Household composition","With no children < 18 yrs",NA,76173,69683,91.5,6490,8.5,"3550","4.7","2940","3.9"
"159",2006,"Household composition","With no children < 18 yrs","More than one adult",44742,41822,93.5,2920,6.5,"1769","4","1151","2.6"
"160",2006,"Household composition","With no children < 18 yrs","Women living alone",17587,15600,88.7,1987,11.3,"971","5.5","1016","5.8"
"161",2006,"Household composition","With no children < 18 yrs","Men living alone",13844,12261,88.6,1583,11.4,"810","5.9","773","5.6"
"162",2006,"Household composition","With elderly",NA,26840,25242,94,1598,6,"1108","4.0999999999999996","490","1.8"
"163",2006,"Household composition","With elderly","Elderly living alone",10499,9880,94.1,619,5.9,"394","3.8","225","2.1"
"164",2006,"Race/ethnicity of households","White non-Hispanic",NA,82268,75810,92.2,6458,7.8,"3937","4.8","2521","3.1"
"165",2006,"Race/ethnicity of households","Black non-Hispanic",NA,14054,10991,78.2,3063,21.8,"1944","13.8","1119","8"
"166",2006,"Race/ethnicity of households","Hispanic",NA,12879,10367,80.5,2512,19.5,"1780","13.8","732","5.7"
"167",2006,"Race/ethnicity of households","Other",NA,6409,5793,90.4,616,9.6,"370","5.8","246","3.8"
"168",2006,"Household income-to-poverty ratio","Under 1.00",NA,11829,7533,63.7,4296,36.3,"2540","21.5","1756","14.8"
"169",2006,"Household income-to-poverty ratio","Under 1.30",NA,16830,11265,66.9,5565,33.1,"3363","20","2202","13.1"
"170",2006,"Household income-to-poverty ratio","Under 1.85",NA,27613,20075,72.7,7538,27.3,"4593","16.600000000000001","2945","10.7"
"171",2006,"Household income-to-poverty ratio","1.85 and over",NA,64495,61059,94.7,3436,5.3,"2364","3.7","1072","1.7"
"172",2006,"Household income-to-poverty ratio","Income unknown",NA,23500,21826,92.9,1674,7.1,"1074","4.5999999999999996","600","2.6"
"173",2006,"Area of residence","Inside metropolitan area",NA,96192,85870,89.3,10322,10.7,"6557","6.8","3765","3.9"
"174",2006,"Area of residence","Inside metropolitan area","In principal cities",32054,27832,86.8,4222,13.2,"2622","8.1999999999999993","1600","5"
"175",2006,"Area of residence","Inside metropolitan area","Not in principal cities",47541,43243,91,4298,9,"2793","5.9","1505","3.2"
"176",2006,"Area of residence","Outside metropolitan area",NA,19417,17091,88,2326,12,"1474","7.6","852","4.4000000000000004"
"177",2006,"Census geographic region",NA,"Northeast",21302,19343,90.8,1959,9.2,"1195","5.6","764","3.6"
"178",2006,"Census geographic region",NA,"Midwest",26560,23717,89.3,2843,10.7,"1804","6.8","1039","3.9"
"179",2006,"Census geographic region",NA,"South",42283,37099,87.7,5184,12.3,"3361","7.9","1823","4.3"
"180",2006,"Census geographic region",NA,"West",25464,22802,89.5,2662,10.5,"1671","6.6","991","3.9"
"181",2007,"All households",NA,NA,117100,104089,88.9,13011,11.1,"8262","7","4749","4.0999999999999996"
"182",2007,"Household composition","With children < 18 yrs",NA,39390,33160,84.2,6230,15.8,"4376","11.1","1854","4.7"
"183",2007,"Household composition","With children < 18 yrs","With children < 6 yrs",17549,14550,82.9,2999,17.1,"2251","12.8","748","4.3"
"184",2007,"Household composition","With children < 18 yrs","Married-couple families",26645,23852,89.5,2793,10.5,"2074","7.8","719","2.7"
"185",2007,"Household composition","With children < 18 yrs","Female head, no spouse",9458,6600,69.8,2858,30.2,"1882","19.899999999999999","976","10.3"
"186",2007,"Household composition","With children < 18 yrs","Male head, no spouse",2621,2150,82,471,18,"335","12.8","136","5.2"
"187",2007,"Household composition","With children < 18 yrs","Other household with child",667,560,84,107,16,"84","12.6","23","3.4"
"188",2007,"Household composition","With no children < 18 yrs",NA,77710,70928,91.3,6782,8.7,"3887","5","2895","3.7"
"189",2007,"Household composition","With no children < 18 yrs","More than one adult",45350,42291,93.3,3059,6.7,"1851","4.0999999999999996","1208","2.7"
"190",2007,"Household composition","With no children < 18 yrs","Women living alone",18395,16242,88.3,2153,11.7,"1179","6.4","974","5.3"
"191",2007,"Household composition","With no children < 18 yrs","Men living alone",13966,12396,88.8,1570,11.2,"856","6.1","714","5.0999999999999996"
"192",2007,"Household composition","With elderly",NA,27469,25692,93.5,1777,6.5,"1131","4.0999999999999996","646","2.4"
"193",2007,"Household composition","With elderly","Elderly living alone",10746,9963,92.7,783,7.3,"480","4.5","303","2.8"
"194",2007,"Race/ethnicity of households","White non-Hispanic",NA,82882,76342,92.1,6540,7.9,"4008","4.8","2532","3.1"
"195",2007,"Race/ethnicity of households","Black non-Hispanic",NA,14209,11057,77.8,3152,22.2,"2064","14.5","1088","7.7"
"196",2007,"Race/ethnicity of households","Hispanic",NA,13378,10694,79.9,2684,20.1,"1798","13.4","886","6.6"
"197",2007,"Race/ethnicity of households","Other",NA,6632,5996,90.4,636,9.6,"392","5.9","244","3.7"
"198",2007,"Household income-to-poverty ratio","Under 1.00",NA,11688,7282,62.3,4406,37.7,"2669","22.8","1737","14.9"
"199",2007,"Household income-to-poverty ratio","Under 1.30",NA,17395,11451,65.8,5944,34.2,"3574","20.5","2370","13.6"
"200",2007,"Household income-to-poverty ratio","Under 1.85",NA,27378,19534,71.3,7844,28.7,"4780","17.5","3064","11.2"
"201",2007,"Household income-to-poverty ratio","1.85 and over",NA,65898,62244,94.5,3654,5.5,"2429","3.7","1225","1.9"
"202",2007,"Household income-to-poverty ratio","Income unknown",NA,23825,22312,93.6,1513,6.4,"1053","4.4000000000000004","460","1.9"
"203",2007,"Area of residence","Inside metropolitan area",NA,97572,86850,89,10722,11,"6807","7","3915","4"
"204",2007,"Area of residence","Inside metropolitan area","In principal cities",32843,28420,86.5,4423,13.5,"2772","8.4","1651","5"
"205",2007,"Area of residence","Inside metropolitan area","Not in principal cities",47971,43640,91,4331,9,"2865","6","1466","3.1"
"206",2007,"Area of residence","Outside metropolitan area",NA,19528,17239,88.3,2289,11.7,"1455","7.5","834","4.3"
"207",2007,"Census geographic region",NA,"Northeast",21353,19147,89.7,2206,10.3,"1469","6.9","737","3.5"
"208",2007,"Census geographic region",NA,"Midwest",26506,23658,89.3,2848,10.7,"1741","6.6","1107","4.2"
"209",2007,"Census geographic region",NA,"South",43246,38145,88.2,5101,11.8,"3262","7.5","1839","4.3"
"210",2007,"Census geographic region",NA,"West",25995,23139,89,2856,11,"1790","6.9","1066","4.0999999999999996"
"211",2008,"All households",NA,NA,117565,100416,85.4,17149,14.6,"10426","8.9","6723","5.7"
"212",2008,"Household composition","With children < 18 yrs",NA,39699,31364,79,8335,21,"5718","14.4","2617","6.6"
"213",2008,"Household composition","With children < 18 yrs","With children < 6 yrs",17503,13595,77.7,3908,22.3,"2818","16.100000000000001","1090","6.2"
"214",2008,"Household composition","With children < 18 yrs","Married-couple families",26705,22887,85.7,3818,14.3,"2735","10.199999999999999","1083","4.0999999999999996"
"215",2008,"Household composition","With children < 18 yrs","Female head, no spouse",9639,6057,62.8,3582,37.2,"2296","23.8","1286","13.3"
"216",2008,"Household composition","With children < 18 yrs","Male head, no spouse",2782,2013,72.4,769,27.6,"569","20.5","200","7.2"
"217",2008,"Household composition","With children < 18 yrs","Other household with child",572,405,70.8,167,29.2,"118","20.6","49","8.6"
"218",2008,"Household composition","With no children < 18 yrs",NA,77866,69052,88.7,8814,11.3,"4708","6","4106","5.3"
"219",2008,"Household composition","With no children < 18 yrs","More than one adult",45772,41610,90.9,4162,9.1,"2409","5.3","1753","3.8"
"220",2008,"Household composition","With no children < 18 yrs","Women living alone",17934,15266,85.1,2668,14.9,"1284","7.2","1384","7.7"
"221",2008,"Household composition","With no children < 18 yrs","Men living alone",14160,12177,86,1983,14,"1015","7.2","968","6.8"
"222",2008,"Household composition","With elderly",NA,28211,25927,91.9,2284,8.1,"1402","5","882","3.1"
"223",2008,"Household composition","With elderly","Elderly living alone",11148,10168,91.2,980,8.8,"552","5","428","3.8"
"224",2008,"Race/ethnicity of households","White non-Hispanic",NA,82935,74041,89.3,8894,10.7,"5154","6.2","3740","4.5"
"225",2008,"Race/ethnicity of households","Black non-Hispanic",NA,14441,10732,74.3,3709,25.7,"2251","15.6","1458","10.1"
"226",2008,"Race/ethnicity of households","Hispanic",NA,13504,9873,73.1,3631,26.9,"2439","18.100000000000001","1192","8.8000000000000007"
"227",2008,"Race/ethnicity of households","Other",NA,6686,5772,86.3,914,13.7,"582","8.6999999999999993","332","5"
"228",2008,"Household income-to-poverty ratio","Under 1.00",NA,13117,7576,57.8,5541,42.2,"3014","23","2527","19.3"
"229",2008,"Household income-to-poverty ratio","Under 1.30",NA,20383,12427,61,7956,39,"4403","21.6","3553","17.399999999999999"
"230",2008,"Household income-to-poverty ratio","Under 1.85",NA,29680,19622,66.1,10058,33.9,"5731","19.3","4327","14.6"
"231",2008,"Household income-to-poverty ratio","1.85 and over",NA,70433,65038,92.3,5395,7.7,"3595","5.0999999999999996","1800","2.6"
"232",2008,"Household income-to-poverty ratio","Income unknown",NA,17452,15755,90.3,1697,9.7,"1101","6.3","596","3.4"
"233",2008,"Area of residence","Inside metropolitan area",NA,98189,83790,85.3,14399,14.7,"8757","8.9","5642","5.7"
"234",2008,"Area of residence","Inside metropolitan area","In principal cities",32808,27006,82.3,5802,17.7,"3634","11.1","2168","6.6"
"235",2008,"Area of residence","Inside metropolitan area","Not in principal cities",48239,42125,87.3,6114,12.7,"3650","7.6","2464","5.0999999999999996"
"236",2008,"Area of residence","Outside metropolitan area",NA,19375,16625,85.8,2750,14.2,"1669","8.6","1081","5.6"
"237",2008,"Census geographic region",NA,"Northeast",21341,18616,87.2,2725,12.8,"1610","7.5","1115","5.2"
"238",2008,"Census geographic region",NA,"Midwest",26370,22671,86,3699,14,"2254","8.5","1445","5.5"
"239",2008,"Census geographic region",NA,"South",43542,36621,84.1,6921,15.9,"4216","9.6999999999999993","2705","6.2"
"240",2008,"Census geographic region",NA,"West",26311,22507,85.5,3804,14.5,"2346","8.9","1458","5.5"
"241",2009,"All households",NA,NA,118174,100820,85.3,17354,14.7,"10601","9","6753","5.7"
"242",2009,"Household composition","With children < 18 yrs",NA,39525,31114,78.7,8411,21.3,"5812","14.7","2599","6.6"
"243",2009,"Household composition","With children < 18 yrs","With children < 6 yrs",17598,13566,77.1,4032,22.9,"2896","16.5","1136","6.5"
"244",2009,"Household composition","With children < 18 yrs","Married-couple families",26334,22475,85.3,3859,14.7,"2818","10.7","1041","4"
"245",2009,"Household composition","With children < 18 yrs","Female head, no spouse",9700,6146,63.4,3554,36.6,"2300","23.7","1254","12.9"
"246",2009,"Household composition","With children < 18 yrs","Male head, no spouse",2883,2082,72.2,801,27.8,"561","19.5","240","8.3000000000000007"
"247",2009,"Household composition","With children < 18 yrs","Other household with child",607,410,67.5,197,32.5,"133","21.9","64","10.5"
"248",2009,"Household composition","With no children < 18 yrs",NA,78649,69706,88.6,8943,11.4,"4789","6.1","4154","5.3"
"249",2009,"Household composition","With no children < 18 yrs","More than one adult",46677,42404,90.8,4273,9.2,"2443","5.2","1830","3.9"
"250",2009,"Household composition","With no children < 18 yrs","Women living alone",17662,15064,85.3,2598,14.7,"1288","7.3","1310","7.4"
"251",2009,"Household composition","With no children < 18 yrs","Men living alone",14310,12238,85.5,2072,14.5,"1058","7.4","1014","7.1"
"252",2009,"Household composition","With elderly",NA,28912,26743,92.5,2169,7.5,"1416","4.9000000000000004","753","2.6"
"253",2009,"Household composition","With elderly","Elderly living alone",11300,10416,92.2,884,7.8,"536","4.7","348","3.1"
"254",2009,"Race/ethnicity of households","White non-Hispanic",NA,83259,74066,89,9193,11,"5394","6.5","3799","4.5999999999999996"
"255",2009,"Race/ethnicity of households","Black non-Hispanic",NA,14519,10908,75.1,3611,24.9,"2259","15.6","1352","9.3000000000000007"
"256",2009,"Race/ethnicity of households","Hispanic",NA,13566,9922,73.1,3644,26.9,"2388","17.600000000000001","1256","9.3000000000000007"
"257",2009,"Race/ethnicity of households","Other",NA,6830,5926,86.8,904,13.2,"559","8.1999999999999993","345","5.0999999999999996"
"258",2009,"Household income-to-poverty ratio","Under 1.00",NA,13193,7525,57,5668,43,"3221","24.4","2447","18.5"
"259",2009,"Household income-to-poverty ratio","Under 1.30",NA,19913,12000,60.3,7913,39.7,"4520","22.7","3393","17"
"260",2009,"Household income-to-poverty ratio","Under 1.85",NA,29454,19194,65.2,10260,34.8,"6020","20.399999999999999","4240","14.4"
"261",2009,"Household income-to-poverty ratio","1.85 and over",NA,63983,59125,92.4,4858,7.6,"3161","4.9000000000000004","1697","2.7"
"262",2009,"Household income-to-poverty ratio","Income unknown",NA,24738,22503,91,2235,9,"1420","5.7","815","3.3"
"263",2009,"Area of residence","Inside metropolitan area",NA,98336,83803,85.2,14533,14.8,"8843","9","5690","5.8"
"264",2009,"Area of residence","Inside metropolitan area","In principal cities",32690,27059,82.8,5631,17.2,"3417","10.5","2214","6.8"
"265",2009,"Area of residence","Inside metropolitan area","Not in principal cities",48698,42261,86.8,6437,13.2,"3912","8","2525","5.2"
"266",2009,"Area of residence","Outside metropolitan area",NA,19838,17017,85.8,2821,14.2,"1757","8.9","1064","5.4"
"267",2009,"Census geographic region",NA,"Northeast",21403,18787,87.8,2616,12.2,"1591","7.4","1025","4.8"
"268",2009,"Census geographic region",NA,"Midwest",26512,22836,86.1,3676,13.9,"2251","8.5","1425","5.4"
"269",2009,"Census geographic region",NA,"South",43842,36885,84.1,6957,15.9,"4228","9.6","2729","6.2"
"270",2009,"Census geographic region",NA,"West",26417,22312,84.5,4105,15.5,"2531","9.6","1574","6"
"271",2010,"All households",NA,NA,118756,101527,85.5,17229,14.5,"10872","9.1999999999999993","6357","5.4"
"272",2010,"Household composition","With children < 18 yrs",NA,39419,31447,79.8,7972,20.2,"5724","14.5","2248","5.7"
"273",2010,"Household composition","With children < 18 yrs","With children < 6 yrs",17780,13899,78.2,3881,21.8,"2850","16","1031","5.8"
"274",2010,"Household composition","With children < 18 yrs","Married-couple families",25729,22179,86.2,3550,13.8,"2636","10.199999999999999","914","3.6"
"275",2010,"Household composition","With children < 18 yrs","Female head, no spouse",10081,6547,64.9,3534,35.1,"2450","24.3","1084","10.8"
"276",2010,"Household composition","With children < 18 yrs","Male head, no spouse",2980,2223,74.6,757,25.4,"558","18.7","199","6.7"
"277",2010,"Household composition","With children < 18 yrs","Other household with child",629,498,79.2,131,20.8,"81","12.9","50","7.9"
"278",2010,"Household composition","With no children < 18 yrs",NA,79337,70080,88.3,9257,11.7,"5148","6.5","4109","5.2"
"279",2010,"Household composition","With no children < 18 yrs","More than one adult",47112,42468,90.1,4644,9.9,"2781","5.9","1863","4"
"280",2010,"Household composition","With no children < 18 yrs","Women living alone",17644,15218,86.3,2426,13.7,"1329","7.5","1097","6.2"
"281",2010,"Household composition","With no children < 18 yrs","Men living alone",14582,12394,85,2188,15,"1038","7.1","1150","7.9"
"282",2010,"Household composition","With elderly",NA,29438,27102,92.1,2336,7.9,"1563","5.3","773","2.6"
"283",2010,"Household composition","With elderly","Elderly living alone",11565,10640,92,925,8,"551","4.8","374","3.2"
"284",2010,"Race/ethnicity of households","White non-Hispanic",NA,83113,74117,89.2,8996,10.8,"5512","6.6","3484","4.2"
"285",2010,"Race/ethnicity of households","Black non-Hispanic",NA,14600,10941,74.9,3659,25.1,"2332","16","1327","9.1"
"286",2010,"Race/ethnicity of households","Hispanic",NA,14109,10416,73.8,3693,26.2,"2507","17.8","1186","8.4"
"287",2010,"Race/ethnicity of households","Other",NA,6933,6052,87.3,881,12.7,"521","7.5","360","5.2"
"288",2010,"Household income-to-poverty ratio","Under 1.00",NA,15133,9056,59.8,6077,40.2,"3584","23.7","2493","16.5"
"289",2010,"Household income-to-poverty ratio","Under 1.30",NA,20907,13039,62.4,7868,37.6,"4757","22.8","3111","14.9"
"290",2010,"Household income-to-poverty ratio","Under 1.85",NA,30101,19940,66.2,10161,33.8,"6232","20.7","3929","13.1"
"291",2010,"Household income-to-poverty ratio","1.85 and over",NA,62335,57710,92.6,4625,7.4,"3092","5","1533","2.5"
"292",2010,"Household income-to-poverty ratio","Income unknown",NA,26319,23876,90.7,2443,9.3,"1548","5.9","895","3.4"
"293",2010,"Area of residence","Inside metropolitan area",NA,98657,84379,85.5,14278,14.5,"9015","9.1","5263","5.3"
"294",2010,"Area of residence","Inside metropolitan area","In principal cities",32732,27171,83,5561,17,"3491","10.7","2070","6.3"
"295",2010,"Area of residence","Inside metropolitan area","Not in principal cities",49000,42831,87.4,6169,12.6,"3902","8","2267","4.5999999999999996"
"296",2010,"Area of residence","Outside metropolitan area",NA,20099,17147,85.3,2952,14.7,"1858","9.1999999999999993","1094","5.4"
"297",2010,"Census geographic region",NA,"Northeast",21731,19036,87.6,2695,12.4,"1665","7.7","1030","4.7"
"298",2010,"Census geographic region",NA,"Midwest",26589,23062,86.7,3527,13.3,"2153","8.1","1374","5.2"
"299",2010,"Census geographic region",NA,"South",44270,37203,84,7067,16,"4591","10.4","2476","5.6"
"300",2010,"Census geographic region",NA,"West",26166,22226,84.9,3940,15.1,"2463","9.4","1477","5.6"
"301",2011,"All households",NA,NA,119484,101631,85.1,17853,14.9,"11014","9.1999999999999993","6839","5.7"
"302",2011,"Household composition","With children < 18 yrs",NA,38803,30814,79.4,7989,20.6,"5750","14.8","2239","5.8"
"303",2011,"Household composition","With children < 18 yrs","With children < 6 yrs",17281,13494,78.1,3787,21.9,"2884","16.7","903","5.2"
"304",2011,"Household composition","With children < 18 yrs","Married-couple families",25421,21879,86.1,3542,13.9,"2671","10.5","871","3.4"
"305",2011,"Household composition","With children < 18 yrs","Female head, no spouse",9690,6124,63.2,3566,36.8,"2452","25.3","1114","11.5"
"306",2011,"Household composition","With children < 18 yrs","Male head, no spouse",3055,2295,75.1,760,24.9,"532","17.399999999999999","228","7.5"
"307",2011,"Household composition","With children < 18 yrs","Other household with child",638,517,81,121,19,"96","15","25","3.9"
"308",2011,"Household composition","With no children < 18 yrs",NA,80681,70817,87.8,9864,12.2,"5264","6.5","4600","5.7"
"309",2011,"Household composition","With no children < 18 yrs","More than one adult",47863,43103,90.1,4760,9.9,"2778","5.8","1982","4.0999999999999996"
"310",2011,"Household composition","With no children < 18 yrs","Women living alone",18021,15205,84.4,2816,15.6,"1387","7.7","1429","7.9"
"311",2011,"Household composition","With no children < 18 yrs","Men living alone",14796,12508,84.5,2288,15.5,"1099","7.4","1189","8"
"312",2011,"Household composition","With elderly",NA,30099,27579,91.6,2520,8.4,"1589","5.3","931","3.1"
"313",2011,"Household composition","With elderly","Elderly living alone",11402,10400,91.2,1002,8.8,"579","5.0999999999999996","423","3.7"
"314",2011,"Race/ethnicity of households","White non-Hispanic",NA,83304,73823,88.6,9481,11.4,"5689","6.8","3792","4.5999999999999996"
"315",2011,"Race/ethnicity of households","Black non-Hispanic",NA,14765,11066,74.9,3699,25.1,"2155","14.6","1544","10.5"
"316",2011,"Race/ethnicity of households","Hispanic",NA,14410,10629,73.8,3781,26.2,"2583","17.899999999999999","1198","8.3000000000000007"
"317",2011,"Race/ethnicity of households","Other",NA,7005,6113,87.3,892,12.7,"587","8.4","305","4.4000000000000004"
"318",2011,"Household income-to-poverty ratio","Under 1.00",NA,15557,9164,58.9,6393,41.1,"3616","23.2","2777","17.899999999999999"
"319",2011,"Household income-to-poverty ratio","Under 1.30",NA,22168,13825,62.4,8343,37.6,"4763","21.5","3580","16.100000000000001"
"320",2011,"Household income-to-poverty ratio","Under 1.85",NA,31437,20593,65.5,10844,34.5,"6376","20.3","4468","14.2"
"321",2011,"Household income-to-poverty ratio","1.85 and over",NA,62244,57888,93,4356,7,"2938","4.7","1418","2.2999999999999998"
"322",2011,"Household income-to-poverty ratio","Income unknown",NA,25802,23149,89.7,2653,10.3,"1700","6.6","953","3.7"
"323",2011,"Area of residence","Inside metropolitan area",NA,99835,84999,85.1,14836,14.9,"9163","9.1999999999999993","5673","5.7"
"324",2011,"Area of residence","Inside metropolitan area","In principal cities",33515,27597,82.3,5918,17.7,"3646","10.9","2272","6.8"
"325",2011,"Area of residence","Inside metropolitan area","Not in principal cities",49253,42770,86.8,6483,13.2,"4013","8.1","2470","5"
"326",2011,"Area of residence","Outside metropolitan area",NA,19649,16632,84.6,3017,15.4,"1851","9.4","1166","5.9"
"327",2011,"Census geographic region",NA,"Northeast",21650,18736,86.5,2914,13.5,"1777","8.1999999999999993","1137","5.3"
"328",2011,"Census geographic region",NA,"Midwest",26359,22798,86.5,3561,13.5,"2141","8.1","1420","5.4"
"329",2011,"Census geographic region",NA,"South",44772,37618,84,7154,16,"4431","9.9","2723","6.1"
"330",2011,"Census geographic region",NA,"West",26703,22478,84.2,4225,15.8,"2665","10","1560","5.8"
"331",2012,"All households",NA,NA,121546,103914,85.5,17632,14.5,"10679","8.8000000000000007","6953","5.7"
"332",2012,"Household composition","With children < 18 yrs",NA,39201,31354,80,7847,20,"5478","14","2369","6"
"333",2012,"Household composition","With children < 18 yrs","With children < 6 yrs",17325,13770,79.5,3555,20.5,"2608","15.1","947","5.5"
"334",2012,"Household composition","With children < 18 yrs","Married-couple families",25233,21907,86.8,3326,13.2,"2500","9.9","826","3.3"
"335",2012,"Household composition","With children < 18 yrs","Female head, no spouse",10373,6705,64.6,3668,35.4,"2351","22.7","1317","12.7"
"336",2012,"Household composition","With children < 18 yrs","Male head, no spouse",3008,2299,76.4,709,23.6,"519","17.3","190","6.3"
"337",2012,"Household composition","With children < 18 yrs","Other household with child",587,443,75.5,144,24.5,"108","18.399999999999999","36","6.1"
"338",2012,"Household composition","With no children < 18 yrs",NA,82345,72560,88.1,9785,11.9,"5201","6.3","4584","5.6"
"339",2012,"Household composition","With no children < 18 yrs","More than one adult",49577,44726,90.2,4851,9.8,"2695","5.4","2156","4.3"
"340",2012,"Household composition","With no children < 18 yrs","Women living alone",17903,15162,84.7,2741,15.3,"1400","7.8","1341","7.5"
"341",2012,"Household composition","With no children < 18 yrs","Men living alone",14865,12673,85.3,2192,14.7,"1106","7.4","1086","7.3"
"342",2012,"Household composition","With elderly",NA,31932,29122,91.2,2810,8.8,"1682","5.3","1128","3.5"
"343",2012,"Household composition","With elderly","Elderly living alone",11706,10643,90.9,1063,9.1,"595","5.0999999999999996","468","4"
"344",2012,"Race/ethnicity of households","White non-Hispanic",NA,83217,73914,88.8,9303,11.2,"5452","6.6","3851","4.5999999999999996"
"345",2012,"Race/ethnicity of households","Black non-Hispanic",NA,14976,11287,75.4,3689,24.6,"2136","14.3","1553","10.4"
"346",2012,"Race/ethnicity of households","Hispanic",NA,15613,11982,76.7,3631,23.3,"2469","15.8","1162","7.4"
"347",2012,"Race/ethnicity of households","Other",NA,7740,6730,87,1010,13,"623","8","387","5"
"348",2012,"Household income-to-poverty ratio","Under 1.00",NA,15547,9196,59.1,6351,40.9,"3526","22.7","2825","18.2"
"349",2012,"Household income-to-poverty ratio","Under 1.30",NA,21797,13472,61.8,8325,38.2,"4676","21.5","3649","16.7"
"350",2012,"Household income-to-poverty ratio","Under 1.85",NA,31259,20534,65.7,10725,34.3,"6197","19.8","4528","14.5"
"351",2012,"Household income-to-poverty ratio","1.85 and over",NA,64274,59882,93.2,4392,6.8,"2916","4.5","1476","2.2999999999999998"
"352",2012,"Household income-to-poverty ratio","Income unknown",NA,26013,23497,90.3,2516,9.7,"1567","6","949","3.6"
"353",2012,"Area of residence","Inside metropolitan area",NA,101476,86961,85.7,14515,14.3,"8809","8.6999999999999993","5706","5.6"
"354",2012,"Area of residence","Inside metropolitan area","In principal cities",33959,28214,83.1,5745,16.9,"3468","10.199999999999999","2277","6.7"
"355",2012,"Area of residence","Inside metropolitan area","Not in principal cities",50358,43957,87.3,6401,12.7,"3930","7.8","2471","4.9000000000000004"
"356",2012,"Area of residence","Outside metropolitan area",NA,20070,16953,84.5,3117,15.5,"1870","9.3000000000000007","1247","6.2"
"357",2012,"Census geographic region",NA,"Northeast",21693,19102,88.1,2591,11.9,"1594","7.3","997","4.5999999999999996"
"358",2012,"Census geographic region",NA,"Midwest",27051,23222,85.8,3829,14.2,"2128","7.9","1701","6.3"
"359",2012,"Census geographic region",NA,"South",45731,38404,84,7327,16,"4660","10.199999999999999","2667","5.8"
"360",2012,"Census geographic region",NA,"West",27071,23186,85.6,3885,14.4,"2297","8.5","1588","5.9"
"361",2013,"All households",NA,NA,122579,105070,85.7,17509,14.3,"10664","8.6999999999999993","6845","5.6"
"362",2013,"Household composition","With children < 18 yrs",NA,38486,30979,80.5,7507,19.5,"5240","13.6","2267","5.9"
"363",2013,"Household composition","With children < 18 yrs","With children < 6 yrs",16942,13405,79.1,3537,20.9,"2556","15.1","981","5.8"
"364",2013,"Household composition","With children < 18 yrs","Married-couple families",24896,21700,87.2,3196,12.8,"2283","9.1999999999999993","913","3.7"
"365",2013,"Household composition","With children < 18 yrs","Female head, no spouse",10025,6577,65.6,3448,34.4,"2362","23.6","1086","10.8"
"366",2013,"Household composition","With children < 18 yrs","Male head, no spouse",3025,2327,76.9,698,23.1,"501","16.600000000000001","197","6.5"
"367",2013,"Household composition","With children < 18 yrs","Other household with child",540,374,69.3,166,30.7,"95","17.600000000000001","71","13.1"
"368",2013,"Household composition","With no children < 18 yrs",NA,84093,74092,88.1,10001,11.9,"5423","6.4","4578","5.4"
"369",2013,"Household composition","With no children < 18 yrs","More than one adult",50145,45201,90.1,4944,9.9,"2913","5.8","2031","4.0999999999999996"
"370",2013,"Household composition","With no children < 18 yrs","Women living alone",18686,15853,84.8,2833,15.2,"1453","7.8","1380","7.4"
"371",2013,"Household composition","With no children < 18 yrs","Men living alone",15263,13038,85.4,2225,14.6,"1058","6.9","1167","7.6"
"372",2013,"Household composition","With elderly",NA,33244,30354,91.3,2890,8.7,"1866","5.6","1024","3.1"
"373",2013,"Household composition","With elderly","Elderly living alone",12341,11232,91,1109,9,"657","5.3","452","3.7"
"374",2013,"Race/ethnicity of households","White non-Hispanic",NA,83496,74636,89.4,8860,10.6,"5033","6","3827","4.5999999999999996"
"375",2013,"Race/ethnicity of households","Black non-Hispanic",NA,15311,11322,73.9,3989,26.1,"2442","15.9","1547","10.1"
"376",2013,"Race/ethnicity of households","Hispanic",NA,15648,11939,76.3,3709,23.7,"2660","17","1049","6.7"
"377",2013,"Race/ethnicity of households","Other",NA,8124,7175,88.3,949,11.7,"528","6.5","421","5.2"
"378",2013,"Household income-to-poverty ratio","Under 1.00",NA,14819,8583,57.9,6236,42.1,"3489","23.5","2747","18.5"
"379",2013,"Household income-to-poverty ratio","Under 1.30",NA,20715,12657,61.1,8058,38.9,"4589","22.2","3469","16.7"
"380",2013,"Household income-to-poverty ratio","Under 1.85",NA,29809,19429,65.2,10380,34.8,"6089","20.399999999999999","4291","14.4"
"381",2013,"Household income-to-poverty ratio","1.85 and over",NA,62985,58774,93.3,4211,6.7,"2784","4.4000000000000004","1427","2.2999999999999998"
"382",2013,"Household income-to-poverty ratio","Income unknown",NA,29786,26869,90.2,2917,9.8,"1790","6","1127","3.8"
"383",2013,"Area of residence","Inside metropolitan area",NA,102936,88384,85.9,14552,14.1,"8857","8.6","5695","5.5"
"384",2013,"Area of residence","Inside metropolitan area","In principal cities",34425,28667,83.3,5758,16.7,"3593","10.4","2165","6.3"
"385",2013,"Area of residence","Inside metropolitan area","Not in principal cities",51077,44904,87.9,6173,12.1,"3721","7.3","2452","4.8"
"386",2013,"Area of residence","Outside metropolitan area",NA,19643,16686,84.9,2957,15.1,"1807","9.1999999999999993","1150","5.9"
"387",2013,"Census geographic region",NA,"Northeast",21894,19190,87.6,2704,12.4,"1636","7.5","1068","4.9000000000000004"
"388",2013,"Census geographic region",NA,"Midwest",27097,23420,86.4,3677,13.6,"2198","8.1","1479","5.5"
"389",2013,"Census geographic region",NA,"South",46256,38974,84.3,7282,15.7,"4421","9.6","2861","6.2"
"390",2013,"Census geographic region",NA,"West",27331,23486,85.9,3845,14.1,"2408","8.8000000000000007","1437","5.3"
"391",2014,"All households",NA,NA,124044,106618,86,17426,14,"10488","8.4","6938","5.6"
"392",2014,"Household composition","With children < 18 yrs",NA,39079,31590,80.8,7489,19.2,"5147","13.2","2342","6"
"393",2014,"Household composition","With children < 18 yrs","With children < 6 yrs",17211,13786,80.1,3425,19.9,"2457","14.3","968","5.6"
"394",2014,"Household composition","With children < 18 yrs","Married-couple families",25376,22226,87.6,3150,12.4,"2346","9.1999999999999993","804","3.2"
"395",2014,"Household composition","With children < 18 yrs","Female head, no spouse",9912,6411,64.7,3501,35.3,"2230","22.5","1271","12.8"
"396",2014,"Household composition","With children < 18 yrs","Male head, no spouse",3237,2533,78.3,704,21.7,"476","14.7","228","7"
"397",2014,"Household composition","With children < 18 yrs","Other household with child",554,419,75.6,135,24.4,"96","17.3","39","7"
"398",2014,"Household composition","With no children < 18 yrs",NA,84965,75029,88.3,9936,11.7,"5340","6.3","4596","5.4"
"399",2014,"Household composition","With no children < 18 yrs","More than one adult",50621,45731,90.3,4890,9.7,"2772","5.5","2118","4.2"
"400",2014,"Household composition","With no children < 18 yrs","Women living alone",19062,16149,84.7,2913,15.3,"1541","8.1","1372","7.2"
"401",2014,"Household composition","With no children < 18 yrs","Men living alone",15283,13150,86,2133,14,"1027","6.7","1106","7.2"
"402",2014,"Household composition","With elderly",NA,34269,31230,91.1,3039,8.9,"1941","5.7","1098","3.2"
"403",2014,"Household composition","With elderly","Elderly living alone",12792,11608,90.7,1184,9.3,"704","5.5","480","3.8"
"404",2014,"Race/ethnicity of households","White non-Hispanic",NA,84127,75335,89.5,8792,10.5,"4966","5.9","3826","4.5"
"405",2014,"Race/ethnicity of households","Black non-Hispanic",NA,15424,11393,73.9,4031,26.1,"2434","15.8","1597","10.4"
"406",2014,"Race/ethnicity of households","Hispanic",NA,16148,12527,77.6,3621,22.4,"2502","15.5","1119","6.9"
"407",2014,"Race/ethnicity of households","Other",NA,8346,7365,88.2,981,11.8,"585","7","396","4.7"
"408",2014,"Household income-to-poverty ratio","Under 1.00",NA,15812,9560,60.5,6252,39.5,"3409","21.6","2843","18"
"409",2014,"Household income-to-poverty ratio","Under 1.30",NA,20783,13009,62.6,7774,37.4,"4290","20.6","3484","16.8"
"410",2014,"Household income-to-poverty ratio","Under 1.85",NA,31376,20790,66.3,10586,33.7,"6030","19.2","4556","14.5"
"411",2014,"Household income-to-poverty ratio","1.85 and over",NA,64200,60153,93.7,4047,6.3,"2683","4.2","1364","2.1"
"412",2014,"Household income-to-poverty ratio","Income unknown",NA,28468,25676,90.2,2792,9.8,"1775","6.2","1017","3.6"
"413",2014,"Area of residence","Inside metropolitan area",NA,104931,90781,86.5,14150,13.5,"8601","8.1999999999999993","5549","5.3"
"414",2014,"Area of residence","Inside metropolitan area","In principal cities",35672,30085,84.3,5587,15.7,"3476","9.6999999999999993","2111","5.9"
"415",2014,"Area of residence","Inside metropolitan area","Not in principal cities",51892,45779,88.2,6113,11.8,"3600","6.9","2513","4.8"
"416",2014,"Area of residence","Outside metropolitan area",NA,19114,15839,82.9,3275,17.1,"1886","9.9","1389","7.3"
"417",2014,"Census geographic region",NA,"Northeast",22156,19209,86.7,2947,13.3,"1789","8.1","1158","5.2"
"418",2014,"Census geographic region",NA,"Midwest",27260,23489,86.2,3771,13.8,"2180","8","1591","5.8"
"419",2014,"Census geographic region",NA,"South",46869,39803,84.9,7066,15.1,"4235","9","2831","6"
"420",2014,"Census geographic region",NA,"West",27760,24119,86.9,3641,13.1,"2284","8.1999999999999993","1357","4.9000000000000004"
"421",2015,"All households",NA,NA,125164,109315,87.3,15849,12.7,"9540","7.6","6309","5"
"422",2015,"Household composition","With children < 18 yrs",NA,38978,32519,83.4,6459,16.6,"4557","11.7","1902","4.9000000000000004"
"423",2015,"Household composition","With children < 18 yrs","With children < 6 yrs",16995,14129,83.1,2866,16.9,"2146","12.6","720","4.2"
"424",2015,"Household composition","With children < 18 yrs","Married-couple families",25232,22670,89.8,2562,10.2,"1923","7.6","639","2.5"
"425",2015,"Household composition","With children < 18 yrs","Female head, no spouse",10117,7052,69.7,3065,30.3,"2109","20.8","956","9.4"
"426",2015,"Household composition","With children < 18 yrs","Male head, no spouse",3133,2432,77.6,701,22.4,"443","14.1","258","8.1999999999999993"
"427",2015,"Household composition","With children < 18 yrs","Other household with child",496,366,73.8,130,26.2,"82","16.5","48","9.6999999999999993"
"428",2015,"Household composition","With no children < 18 yrs",NA,86187,76796,89.1,9391,10.9,"4983","5.8","4408","5.0999999999999996"
"429",2015,"Household composition","With no children < 18 yrs","More than one adult",51357,46976,91.5,4381,8.5,"2504","4.9000000000000004","1877","3.7"
"430",2015,"Household composition","With no children < 18 yrs","Women living alone",18954,16169,85.3,2785,14.7,"1413","7.5","1372","7.2"
"431",2015,"Household composition","With no children < 18 yrs","Men living alone",15876,13652,86,2224,14,"1065","6.7","1159","7.3"
"432",2015,"Household composition","With elderly",NA,35265,32340,91.7,2925,8.3,"1789","5.0999999999999996","1136","3.2"
"433",2015,"Household composition","With elderly","Elderly living alone",13137,11932,90.8,1205,9.2,"657","5","548","4.2"
"434",2015,"Race/ethnicity of households","White non-Hispanic",NA,83931,75563,90,8368,10,"4759","5.7","3609","4.3"
"435",2015,"Race/ethnicity of households","Black non-Hispanic",NA,15734,12357,78.5,3377,21.5,"2127","13.5","1250","7.9"
"436",2015,"Race/ethnicity of households","Hispanic",NA,16803,13592,80.9,3211,19.1,"2132","12.7","1079","6.4"
"437",2015,"Race/ethnicity of households","Other",NA,8695,7803,89.7,892,10.3,"521","6","371","4.3"
"438",2015,"Household income-to-poverty ratio","Under 1.00",NA,14070,8687,61.7,5383,38.3,"3006","21.4","2377","16.899999999999999"
"439",2015,"Household income-to-poverty ratio","Under 1.30",NA,18917,11954,63.2,6963,36.8,"3966","21","2997","15.8"
"440",2015,"Household income-to-poverty ratio","Under 1.85",NA,28994,19479,67.2,9515,32.8,"5572","19.2","3943","13.6"
"441",2015,"Household income-to-poverty ratio","1.85 and over",NA,65319,61552,94.2,3767,5.8,"2376","3.6","1391","2.1"
"442",2015,"Household income-to-poverty ratio","Income unknown",NA,30851,28282,91.7,2569,8.3,"1593","5.2","976","3.2"
"443",2015,"Area of residence","Inside metropolitan area",NA,106990,93947,87.8,13043,12.2,"7843","7.3","5200","4.9000000000000004"
"444",2015,"Area of residence","Inside metropolitan area","In principal cities",36809,31606,85.9,5203,14.1,"3240","8.8000000000000007","1963","5.3"
"445",2015,"Area of residence","Inside metropolitan area","Not in principal cities",53585,48023,89.6,5562,10.4,"3304","6.2","2258","4.2"
"446",2015,"Area of residence","Outside metropolitan area",NA,18175,15369,84.6,2806,15.4,"1697","9.3000000000000007","1109","6.1"
"447",2015,"Census geographic region",NA,"Northeast",22300,19640,88.1,2660,11.9,"1616","7.2","1044","4.7"
"448",2015,"Census geographic region",NA,"Midwest",27199,23727,87.2,3472,12.8,"2069","7.6","1403","5.2"
"449",2015,"Census geographic region",NA,"South",47389,41101,86.7,6288,13.3,"3750","7.9","2538","5.4"
"450",2015,"Census geographic region",NA,"West",28277,24848,87.9,3429,12.1,"2105","7.4","1324","4.7"
"451",2016,"All households",NA,NA,126401,110850,87.7,15551,12.3,"9413","7.4","6138","4.9000000000000004"
"452",2016,"Household composition","With children < 18 yrs",NA,38400,32059,83.5,6341,16.5,"4501","11.7","1840","4.8"
"453",2016,"Household composition","With children < 18 yrs","With children < 6 yrs",16571,13820,83.4,2751,16.6,"1923","11.6","828","5"
"454",2016,"Household composition","With children < 18 yrs","Married-couple families",25031,22560,90.1,2471,9.9,"1843","7.4","628","2.5"
"455",2016,"Household composition","With children < 18 yrs","Female head, no spouse",9780,6692,68.4,3088,31.6,"2061","21.1","1027","10.5"
"456",2016,"Household composition","With children < 18 yrs","Male head, no spouse",3070,2403,78.3,667,21.7,"509","16.600000000000001","158","5.0999999999999996"
"457",2016,"Household composition","With children < 18 yrs","Other household with child",519,404,77.8,115,22.2,"NA","NA","NA","NA"
"458",2016,"Household composition","With no children < 18 yrs",NA,88001,78792,89.5,9209,10.5,"4911","5.6","4298","4.9000000000000004"
"459",2016,"Household composition","With no children < 18 yrs","More than one adult",52353,48162,92,4191,8,"2411","4.5999999999999996","1780","3.4"
"460",2016,"Household composition","With no children < 18 yrs","Women living alone",19649,16910,86.1,2739,13.9,"1420","7.2","1319","6.7"
"461",2016,"Household composition","With no children < 18 yrs","Men living alone",15999,13719,85.7,2280,14.3,"1080","6.8","1200","7.5"
"462",2016,"Household composition","With elderly",NA,36335,33496,92.2,2839,7.8,"1786","4.9000000000000004","1053","2.9"
"463",2016,"Household composition","With elderly","Elderly living alone",13529,12326,91.1,1203,8.9,"733","5.4","470","3.5"
"464",2016,"Race/ethnicity of households","White non-Hispanic",NA,84087,76271,90.7,7816,9.3,"4591","5.5","3225","3.8"
"465",2016,"Race/ethnicity of households","Black non-Hispanic",NA,15940,12346,77.5,3594,22.5,"2048","12.8","1546","9.6999999999999993"
"466",2016,"Race/ethnicity of households","Hispanic",NA,17054,13907,81.5,3147,18.5,"2152","12.7","995","5.8"
"467",2016,"Race/ethnicity of households","Other",NA,9319,8325,89.3,994,10.7,"622","6.7","372","4"
"468",2016,"Household income-to-poverty ratio","Under 1.00",NA,13929,8598,61.7,5331,38.3,"2920","21","2411","17.3"
"469",2016,"Household income-to-poverty ratio","Under 1.30",NA,18522,11917,64.3,6605,35.7,"3725","20.2","2880","15.5"
"470",2016,"Household income-to-poverty ratio","Under 1.85",NA,29025,19860,68.4,9165,31.6,"5319","18.3","3846","13.3"
"471",2016,"Household income-to-poverty ratio","1.85 and over",NA,67785,64001,94.4,3784,5.6,"2499","3.7","1285","1.9"
"472",2016,"Household income-to-poverty ratio","Income unknown",NA,29590,26988,91.2,2602,8.8,"1595","5.4","1007","3.4"
"473",2016,"Area of residence","Inside metropolitan area",NA,108118,95315,88.2,12803,11.8,"7868","7.2","4935","4.5999999999999996"
"474",2016,"Area of residence","Inside metropolitan area","In principal cities",37176,31879,85.8,5297,14.2,"3117","8.3000000000000007","2180","5.9"
"475",2016,"Area of residence","Inside metropolitan area","Not in principal cities",54399,49222,90.5,5177,9.5,"3286","6","1891","3.5"
"476",2016,"Area of residence","Outside metropolitan area",NA,18283,15535,85,2748,15,"1545","8.4","1203","6.6"
"477",2016,"Census geographic region",NA,"Northeast",22669,20217,89.2,2452,10.8,"1594","7","858","3.8"
"478",2016,"Census geographic region",NA,"Midwest",27307,23976,87.8,3331,12.2,"1871","6.9","1460","5.3"
"479",2016,"Census geographic region",NA,"South",47966,41476,86.5,6490,13.5,"3890","8.1","2600","5.4"
"480",2016,"Census geographic region",NA,"West",28458,25180,88.5,3278,11.5,"2057","7.2","1221","4.3"
"481",2017,"All households",NA,NA,127272,112254,88.2,15018,11.8,"9261","7.3","5757","4.5"
"482",2017,"Household composition","With children < 18 yrs",NA,37942,31976,84.3,5966,15.7,"4421","11.7","1545","4.0999999999999996"
"483",2017,"Household composition","With children < 18 yrs","With children < 6 yrs",16200,13551,83.6,2649,16.4,"2008","12.4","641","4"
"484",2017,"Household composition","With children < 18 yrs","Married-couple families",24744,22383,90.5,2361,9.5,"1876","7.6","485","2"
"485",2017,"Household composition","With children < 18 yrs","Female head, no spouse",9561,6663,69.7,2898,30.3,"2038","21.3","860","9"
"486",2017,"Household composition","With children < 18 yrs","Male head, no spouse",3057,2455,80.3,602,19.7,"429","14","173","5.7"
"487",2017,"Household composition","With children < 18 yrs","Other household with child",581,476,81.9,105,18.1,"NA","NA","NA","NA"
"488",2017,"Household composition","With no children < 18 yrs",NA,89330,80278,89.9,9052,10.1,"4840","5.4","4212","4.7"
"489",2017,"Household composition","With no children < 18 yrs","More than one adult",53107,48997,92.3,4110,7.7,"2357","4.4000000000000004","1753","3.3"
"490",2017,"Household composition","With no children < 18 yrs","Women living alone",19963,17195,86.1,2768,13.9,"1362","6.8","1406","7"
"491",2017,"Household composition","With no children < 18 yrs","Men living alone",16260,14087,86.6,2173,13.4,"1120","6.9","1053","6.5"
"492",2017,"Household composition","With elderly",NA,37805,34814,92.1,2991,7.9,"1833","4.8","1158","3.1"
"493",2017,"Household composition","With elderly","Elderly living alone",14312,13078,91.4,1234,8.6,"710","5","524","3.7"
"494",2017,"Race/ethnicity of households","White non-Hispanic",NA,84548,77083,91.2,7465,8.8,"4389","5.2","3076","3.6"
"495",2017,"Race/ethnicity of households","Black non-Hispanic",NA,16358,12799,78.2,3559,21.8,"2164","13.2","1395","8.5"
"496",2017,"Race/ethnicity of households","Hispanic",NA,17197,14108,82,3089,18,"2137","12.4","952","5.5"
"497",2017,"Race/ethnicity of households","Other",NA,9169,8263,90.1,906,9.9,"572","6.2","334","3.6"
"498",2017,"Household income-to-poverty ratio","Under 1.00",NA,12871,8135,63.2,4736,36.8,"2641","20.5","2095","16.3"
"499",2017,"Household income-to-poverty ratio","Under 1.30",NA,17271,11318,65.5,5953,34.5,"3387","19.600000000000001","2566","14.9"
"500",2017,"Household income-to-poverty ratio","Under 1.85",NA,27012,18699,69.2,8313,30.8,"4901","18.100000000000001","3412","12.6"
"501",2017,"Household income-to-poverty ratio","1.85 and over",NA,69442,65405,94.2,4037,5.8,"2783","4","1254","1.8"
"502",2017,"Household income-to-poverty ratio","Income unknown",NA,30818,28150,91.3,2668,8.7,"1577","5.0999999999999996","1091","3.5"
"503",2017,"Area of residence","Inside metropolitan area",NA,108977,96401,88.5,12576,11.5,"7807","7.2","4769","4.4000000000000004"
"504",2017,"Area of residence","Inside metropolitan area","In principal cities",37365,32199,86.2,5166,13.8,"3132","8.4","2034","5.4"
"505",2017,"Area of residence","Inside metropolitan area","Not in principal cities",55330,50152,90.6,5178,9.4,"3204","5.8","1974","3.6"
"506",2017,"Area of residence","Outside metropolitan area",NA,18295,15853,86.7,2442,13.3,"1454","7.9","988","5.4"
"507",2017,"Census geographic region",NA,"Northeast",22520,20280,90.1,2240,9.9,"1486","6.6","754","3.3"
"508",2017,"Census geographic region",NA,"Midwest",27581,24346,88.3,3235,11.7,"1909","6.9","1326","4.8"
"509",2017,"Census geographic region",NA,"South",48281,41817,86.6,6464,13.4,"3995","8.3000000000000007","2469","5.0999999999999996"
"510",2017,"Census geographic region",NA,"West",28890,25811,89.3,3079,10.7,"1871","6.5","1208","4.2"
